+---------------------------------------------------------------------------------+
| /\ /\  /\  /\   /\   /\   /\   /\    /\  /\/\/\  /\ /\      ()()                |
| /\ /\  /\  /\   /\   /\   /\   /\    /\  /\/\/\  /\ /\   ()()()()               |
| /\ /\  /\  /\   /\   /\   /\   /\    /\  /\/\/\  /\ /\  ()()()\()  ()           |
| /\ /\  /\  /\   /\   /\   /\   /\    /\  /\/\/\  /\ /\   ()()()() ()()          |
| /\ /\  /\  /\   /\   /\   /\   /\    /\  /\/\/\  /\ /\     ()()() //            |
| /\ /\  /\  /\   /\   /\   /\   /\    /\  /\/\/\  /\ /\       ||| //             |
| /\ /\  /\  /\   /\   /\   /\   /\    /\  /\/\/\  /\ /\       |||// /////////////|
| || ||  ||  ||   ||   ||   ||   ||    ||  ||||||  || ||       |||| K             |
|--------------------------------------------------------------------------       |
D                                                                                 |
+---------------------------------------------------------------------------------+